|||||||||||||||||||||||||||||||||||||||||||||||||||||||||||||||||||||||||||||
||  |     |           |           | |           |   |           |           |
||| | ||| | ||||||||| | | ||||||| | | ||| ||||| | ||| ||||||| | ||| | |||||||
|   | |   | |   |   | | | |     | |   | |   |   | |       |   |   | |       |
| ||| | ||| | | | | | | | | | ||| | ||| ||| ||| | | ||||||| ||||| | ||||||| |
| |   |     | |   |   | | | |     |       |   | |     |   |   | | |     | | |
| ||| ||||||| ||||||||| | ||| ||||||||||||||| | ||| ||| | ||| | | ||||| | | |
|   | |     | |         |   |           |     |   | |   | |   | |     |   | |
||| | | ||| | ||||||||||||| ||||||||||| | ||||||| ||| ||| | ||| ||||| ||| | |
| | |     | | |       |   |   |   |   | |     | |     |   | |         |   | |
| | | ||||| | | ||||| | | ||| | | ||| | ||| | | ||||||| ||| | ||||||||| ||| |
|   |   |   |   |  N|   | |   | |   | |   ||| |       | |   | |       |   | |
| ||||| | ||||||| ||||||| | | | ||| | ||| ||| | ||||| | ||| | | | ||| ||||| |
|     | | |       |     | | | | |   |   | |   | |E  | | |   | | | | | |   | |
||||| ||| | ||||| | ||| | | ||| | ||| ||| | ||| ||| | | | ||| ||| | | | | | |
|   |     |   |   |   |   |     | |   |   |   | |   | |   | |     | |   | | |
| | ||||||| | ||| ||| ||||||| ||| | ||| ||||| | | ||| ||||| ||||||| ||||| | |
| |     |   |   | |   |     | |   |     |     |   |     |               | | |
| | ||||| ||||| ||| ||| ||| ||| ||| ||||| | ||||||| ||| | ||||||||| ||||| | |
| | |     |   |   | |   | |   |   |   |   |       | |   |     |   | |     | |
| | | ||||||| ||| | | ||| ||| | | ||| ||||||||| | | | ||||||| | ||| | ||||| |
| | | ||    |   |   |   |     | | |   |       | | | | |     | | |   | |     |
| ||| ||| | | | ||||||| | ||||||| | ||| ||||| ||| | ||| | ||| | | ||| | ||| |
|   |     |   |   |   | | |       |   | |   |     | |   |     | |   |   |   |
| | ||||||||||||| | | | | ||| ||||||| | | ||||||||| | ||||||||| ||| ||||| |||
| |                 |   |     |         |                         |        ||
|||||||||||||||||||||||||||||||||||||||||||||||||||||||||||||||||||||||||||||
|||||||||||||||||||||||||||||||||||||||||||||||||||||||||||||||||||||||||||||
||  |     |           |           | |           |   |           |           |
||| | ||| | ||||||||| | | ||||||| | | ||| ||||| | ||| ||||||| | ||| | |||||||
|   | |   | |   |   | | | |     | |   | |   |   | |       |   |   | |       |
| ||| | ||| | | | | | | | | | ||| | ||| ||| ||| | | ||||||| ||||| | ||||||| |
| |   |     | |   |   | | | |     |       |   | |     |   |   | | |     | | |
| ||| ||||||| ||||||||| | ||| ||||||||||||||| | ||| ||| | ||| | | ||||| | | |
|   | |     | |         |   |           |     |   | |   | |   | |     |   | |
||| | | ||| | ||||||||||||| ||||||||||| | ||||||| ||| ||| | ||| ||||| ||| | |
| | |     | | |       |   |   |   |   | |     | |     |   | |         |   | |
| | | ||||| | | ||||| | | ||| | | ||| | ||| | | ||||||| ||| | ||||||||| ||| |
|   |   |   |   |  N|   | |   | |   | |   ||| |       | |   | |       |   | |
| ||||| | ||||||| ||||||| | | | ||| | ||| ||| | ||||| | ||| | | | ||| ||||| |
|     | | |       |     | | | | |   |   | |   | |E  | | |   | | | | | |   | |
||||| ||| | ||||| | ||| | | ||| | ||| ||| | ||| ||||| | | ||| ||| | | | | | |
|   |     |   |   |   |   |     | |   |   |   | |   | |   | |     | |   | | |
| | ||||||| | ||| ||| ||||||| ||| | ||| ||||| | | ||| ||||| ||||||| ||||| | |
| |     |   |   | |   |     | |   |     |     |   |     |               | | |
| | ||||| ||||| ||| ||| ||| ||| ||| ||||| | ||||||| ||| | ||||||||| ||||| | |
| | |     |   |   | |   | |   |   |   |   |       | |   |     |   | |     | |
| | | ||||||| ||| | | ||| ||| | | ||| ||||||||| | | | ||||||| | ||| | ||||| |
| | | ||    |   |   |   |     | | |   |       | | | | |     | | |   | |     |
| ||| ||| | | | ||||||| | ||||||| | ||| ||||| ||| | ||| | ||| | | ||| | ||| |
|   |     |   |   |   | | |       |   | |   |     | |   |     | |   |   |   |
| | ||||||||||||| | | | | ||| ||||||| | | ||||||||| | ||||||||| ||| ||||| |||
| |                 |   |     |         |                         |        ||
|||||||||||||||||||||||||||||||||||||||||||||||||||||||||||||||||||||||||||||
|||||||||||||||||||||||||||||||||||||||||||||||||||||||||||||||||||||||||||||
||  |     |           |  @@@@@@@@@| |    @@@@@@@|   |        @@@|           |
||| | ||| | ||||||||| | |@|||||||@| | |||@|||||@| ||| |||||||@|@||| | |||||||
|   | |   | |   |   | | |@|     |@|   | |@@@|  @| |       |@@@|@@@| |       |
| ||| | ||| | | | | | | |@| | |||@| ||| |||@|||@| | |||||||@|||||@| ||||||| |
| |   |     | |   |   | |@| |@@@@@|       |@@@|@|     |@@@|@@@| |@|     | | |
| ||| ||||||| ||||||||| |@|||@|||||||||||||||@|@||| |||@|@|||@| |@||||| | | |
|   | |     | |         |@@@|@@@@@@@@@@@|@@@@@|@@@| |@@@|@|@@@| |@@@@@|   | |
||| | | ||| | |||||||||||||@|||||||||||@|@|||||||@|||@|||@|@||| |||||@||| | |
| | |     | | |       |   |@@@|@@@|   |@|@@@@@| |@@@@@|@@@|@|@@@@@@@@@|   | |
| | | ||||| | | ||||| | | |||@|@|@||| |@||| |@| |||||||@|||@|@||||||||| ||| |
|   |   |   |   |@@N|   | |@@@|@|@@@| |@@@|||@|@@@@@@@|@|  @|@|  @@@@@|   | |
| ||||| | |||||||@||||||| |@| |@|||@| |||@|||@|@|||||@|@|||@|@| |@|||@||||| |
|     | | |@@@@@@@|     | |@| |@|@@@|   |@|@@@|@|E@@|@|@|@@@|@| |@| |@|@@@| |
||||| ||| |@||||| | ||| | |@|||@|@||| |||@|@|||@|||@|@|@|@|||@|||@| |@|@|@| |
|   |     |@  |   |   |   |@@@@@|@|   |@@@|@@@|@|@@@|@|@@@| |@@@@@| |@@@|@| |
| | |||||||@| ||| ||| ||||||| |||@| |||@|||||@|@|@|||@||||| ||||||| |||||@| |
| |     |@@@|   | |   |@@@@@| |@@@|@@@@@|  @@@|@@@|@@@  |@@@@@@@@@@@    |@| |
| | |||||@||||| ||| |||@|||@|||@|||@||||| |@|||||||@||| |@|||||||||@|||||@| |
| | |@@@@@|   |   | |@@@| |@@@|@@@|@@@|   |@@@@@@@|@|   |@@@@@|   |@|@@@@@| |
| | |@||||||| ||| | |@||| |||@| |@|||@||||||||| |@|@| |||||||@| |||@|@||||| |
| | |@|| @@@|@@@|   |@@@|@@@@@| |@|@@@|@@@@@@@| |@|@| |@@@  |@| |@@@|@|@@@@@|
| |||@|||@|@|@|@|||||||@|@|||||||@|@|||@|||||@|||@|@|||@|@|||@| |@|||@|@|||@|
|   |@@@@@|@@@|@@@|@@@|@|@|  @@@@@|@@@|@|   |@@@@@|@|@@@|@@@@@| |@@@|@@@|@@@|
| | |||||||||||||@|@|@|@|@|||@|||||||@|@| |||||||||@|@||||||||| |||@|||||@|||
| |              @@@|@@@|@@@@@|      @@@|          @@@            |@@@@@@@ ||
|||||||||||||||||||||||||||||||||||||||||||||||||||||||||||||||||||||||||||||
|||||||||||||||||||||||||||||||||||||||||||||||||||||||||||||||||||||||||||||
||  |     |           |           | |           |   |           |           |
||| | ||| | ||||||||| | | ||||||| | | ||| ||||| | ||| ||||||| | ||| | |||||||
|   | |   | |   |   | | | |     | |   | |   |   | |       |   |   | |       |
| ||| | ||| | | | | | | | | | ||| | ||| ||| ||| | | ||||||| ||||| | ||||||| |
| |   |     | |   |   | | | |     |       |   | |     |   |   | | |     | | |
| ||| ||||||| ||||||||| | ||| ||||||||||||||| | ||| ||| | ||| | | ||||| | | |
|   | |     | |         |   |           |     |   | |   | |   | |     |   | |
||| | | ||| | ||||||||||||| ||||||||||| | ||||||| ||| ||| | ||| ||||| ||| | |
| | |     | | |       |   |   |   |   | |     | |     |   | |         |   | |
| | | ||||| | | ||||| | | ||| | | ||| | ||| | | ||||||| ||| | ||||||||| ||| |
|   |   |   |   |  N|   | |   | |   | |   ||| |       | |   | |       |   | |
| ||||| | ||||||| ||||||| | | | ||| | ||| ||| | ||||| | ||| | | | ||| ||||| |
|     | | |       |     | | | | |   |   | |   | |E  | | |   | | | | | |   | |
||||| ||| | ||||| | ||| | | ||| | ||| ||| | ||| ||||| | | ||| ||| | | | | | |
|   |     |   |   |   |   |     | |   |   |   | |   | |   | |     | |   | | |
| | ||||||| | ||| ||| ||||||| ||| | ||| ||||| | | ||| ||||| ||||||| ||||| | |
| |     |   |   | |   |     | |   |     |     |   |     |               | | |
| | ||||| ||||| ||| ||| ||| ||| ||| ||||| | ||||||| ||| | ||||||||| ||||| | |
| | |     |   |   | |   | |   |   |   |   |       | |   |     |   | |     | |
| | | ||||||| ||| | | ||| ||| | | ||| ||||||||| | | | ||||||| | ||| | ||||| |
| | | ||    |   |   |   |     | | |   |       | | | | |     | | |   | |     |
| ||| ||| | | | ||||||| | ||||||| | ||| ||||| ||| | ||| | ||| | | ||| | ||| |
|   |     |   |   |   | | |       |   | |   |     | |   |     | |   |   |   |
| | ||||||||||||| | | | | ||| ||||||| | | ||||||||| | ||||||||| ||| ||||| |||
| |                 |   |     |         |                         |        ||
|||||||||||||||||||||||||||||||||||||||||||||||||||||||||||||||||||||||||||||
